9,9,9,9,9,9,9,9,9,9,9,9,9,9,9,9,9,9,9,9,9,9,9,9,9,9,9,9,9,9,9,9,9,9,9,9,9,9,9,9,9,9,9,9,9,9,9,9,9,9,9,9,9,9,9,9,9,9,9,9,9,9,9,9,9,9,9,9,9,9,9,9,9,9,9,9,9,9,9,9,9,9,9,9,9,9,9,9,9,9,9,9,9,9,9,9,9,9,9,9,9,9,9,9,9,9,9,9,9,9,9,9,9,9,9,9,9,9,9,9,9,9,9,9,9,9,9,9,9,9,9,9,9,9,9,9,9,9,9,9,9,9,9,9,9,9,9,9,9,9,9,9,9,9,9,9,9,9,9,45,9,9,9,9,9,9,9,9,9,9,9,9,9,9,9,9,9,9,9,9,9,9,9,9,9,9,9,9,9
9,9,9,9,9,9,9,9,9,9,9,9,9,9,9,9,9,9,9,9,9,9,9,9,9,9,9,9,9,9,9,9,9,9,9,9,9,9,9,9,9,9,9,9,9,9,9,9,9,9,9,9,9,9,9,9,9,9,9,9,9,9,9,9,9,9,9,9,9,9,9,9,9,9,9,9,9,9,9,9,9,9,9,9,9,9,9,9,9,9,9,9,9,9,9,9,9,9,9,9,9,9,9,9,9,9,9,9,9,9,9,9,9,9,9,9,9,9,9,9,9,9,9,9,9,9,9,9,9,9,9,9,9,9,9,9,9,9,9,9,9,9,9,9,9,9,9,9,9,9,9,9,9,9,9,9,9,9,9,45,9,9,9,9,9,9,9,9,9,9,9,9,9,9,9,9,9,9,9,9,9,9,9,9,9,9,9,9,9
45,9,997,9,897,9,45,45,45,45,45,45,45,45,45,45,45,45,45,45,45,45,45,45,45,45,45,45,45,45,45,45,45,45,45,45,45,45,45,45,45,45,45,45,45,45,45,45,45,45,45,45,45,45,45,45,45,45,45,45,45,45,45,45,45,45,45,45,45,45,45,45,45,45,45,45,45,45,45,45,45,45,45,45,45,45,45,45,63,45,45,45,45,45,45,45,45,45,45,45,45,45,45,45,45,45,45,45,45,45,45,45,45,45,45,45,45,45,45,45,45,45,45,45,45,45,45,45,45,45,45,45,45,45,45,45,45,9,9,9,9,9,9,9,9,9,9,9,9,9,9,9,9,9,9,9,9,9,9,45,45,45,45,45,45,45,36,37,45,45,45,45,45,45,45,45,45,45,45,45,45,45,45,45,45,9,9,9,45
45,9,9,9,9,9,9,9,9,9,9,9,9,9,9,9,9,9,9,9,9,9,9,9,9,9,9,9,9,9,9,9,9,9,9,9,9,9,9,9,9,9,9,9,9,9,9,9,9,9,9,9,9,9,45,45,9,9,45,45,45,45,45,45,9,9,45,45,45,45,9,9,9,9,9,9,45,45,45,45,9,9,9,9,9,9,9,9,9,9,9,9,9,9,9,9,9,9,9,9,9,9,9,9,9,9,9,9,9,9,9,9,9,9,9,9,9,9,9,9,9,9,9,9,9,9,9,9,9,9,9,9,9,9,9,9,9,9,9,9,9,9,9,9,9,9,9,9,9,9,9,9,9,9,9,9,9,9,9,9,9,9,9,9,9,9,36,37,45,45,45,45,45,45,45,9,9,9,9,9,9,9,9,9,9,9,9,9,45
45,9,9,9,9,9,9,9,9,9,9,9,9,9,9,9,9,9,9,9,9,9,9,9,9,9,9,9,9,9,9,9,9,9,9,9,9,9,9,9,9,9,9,9,9,9,9,9,9,9,9,9,9,9,45,45,9,9,45,45,45,45,45,45,9,9,45,45,45,45,9,9,9,9,9,9,45,45,45,45,9,9,9,9,9,9,9,9,9,9,9,9,9,9,9,9,9,9,9,9,9,9,9,9,9,9,9,9,9,9,9,9,9,9,9,9,9,9,9,9,9,9,9,9,9,9,9,9,9,9,9,9,9,9,9,9,9,9,9,9,9,9,9,9,9,9,9,9,9,9,9,9,9,9,9,9,9,9,9,9,9,9,9,9,9,9,36,37,45,45,45,45,45,45,45,9,9,9,9,9,9,9,9,9,9,9,9,9,45
45,9,9,9,9,9,9,9,9,9,9,9,9,9,9,9,9,9,9,9,9,9,9,9,9,9,9,9,9,9,9,9,9,9,9,9,9,9,9,9,9,49,49,49,49,9,9,9,9,9,9,9,45,45,9,9,9,9,9,9,9,9,45,45,9,9,9,45,9,9,9,9,45,45,9,9,9,9,9,9,9,9,9,49,49,49,49,49,49,9,9,9,9,9,9,9,9,9,9,9,9,9,9,9,9,9,9,9,9,9,9,9,9,9,9,9,9,9,9,9,9,9,9,9,9,9,9,9,9,9,9,9,9,9,9,9,9,9,9,9,9,9,9,9,9,9,9,9,9,9,9,9,9,9,9,9,9,9,9,9,9,9,9,9,9,9,36,37,45,45,45,45,45,45,45,9,9,9,9,9,9,9,9,9,9,9,9,9,45
45,9,9,9,9,9,9,9,9,9,9,9,9,9,9,9,9,9,9,9,9,9,9,9,9,9,9,9,9,9,9,9,9,9,9,9,9,9,9,9,9,9,9,9,9,9,9,9,9,9,9,9,45,45,9,9,9,9,9,9,9,9,45,45,9,9,9,45,9,9,9,9,45,45,9,9,9,9,9,9,9,9,9,9,9,9,9,9,9,9,9,9,9,9,9,9,9,9,9,9,9,9,9,9,9,9,9,9,9,9,9,9,9,9,9,9,9,9,9,9,9,9,9,9,9,9,9,9,9,9,9,9,9,9,9,9,9,9,9,9,9,9,9,9,9,9,9,9,9,9,9,9,9,9,9,9,9,9,9,9,9,9,9,9,9,9,36,37,45,45,45,45,45,45,45,9,9,9,9,9,9,9,9,9,9,9,9,9,45
45,9,9,9,9,9,9,9,9,9,9,9,9,9,9,9,9,9,9,9,9,9,9,9,9,9,9,9,9,9,9,9,9,9,9,9,9,9,9,45,9,45,45,45,45,9,59,9,9,9,9,9,45,45,9,9,9,9,9,9,9,9,45,45,9,9,9,45,9,9,9,9,45,45,9,9,9,9,9,9,9,9,9,45,45,45,45,45,45,9,9,9,9,9,9,9,9,9,9,9,9,9,9,9,9,9,9,9,9,9,9,9,9,9,9,9,9,9,9,9,9,9,9,9,9,9,9,9,9,9,9,9,9,9,9,9,9,9,9,9,9,9,9,9,9,9,9,9,9,9,9,9,9,9,9,9,9,9,9,9,9,9,9,9,9,9,36,37,45,45,45,45,45,45,45,9,9,9,9,9,9,9,9,9,9,9,9,9,45
45,9,9,9,9,9,9,9,9,9,9,9,9,9,9,9,9,9,9,9,9,9,9,9,9,9,9,9,9,61,9,9,9,9,9,9,9,9,9,45,49,45,9,9,45,49,45,9,9,9,9,9,45,45,9,9,9,9,49,49,49,49,45,45,9,9,9,45,49,62,9,9,45,60,9,9,9,9,9,9,9,9,9,45,45,45,45,45,45,9,9,9,9,9,9,9,9,9,9,9,9,9,9,9,9,9,9,9,9,9,9,9,9,9,9,9,9,9,9,9,9,9,9,9,9,9,9,9,9,9,9,9,9,9,9,9,9,9,9,9,9,9,9,9,45,45,45,45,45,62,9,9,9,9,9,9,9,9,9,9,9,9,9,9,42,41,39,37,45,45,45,45,45,45,45,9,9,9,9,9,9,9,9,9,9,9,9,9,45
45,9,9,9,9,9,9,9,9,9,56,55,55,55,55,9,9,9,9,9,9,9,9,58,9,58,9,9,9,9,9,9,9,9,9,9,9,9,9,45,45,45,9,9,45,45,45,9,9,9,9,9,45,45,45,45,9,9,45,45,45,45,45,45,9,9,9,45,45,45,9,9,45,45,9,9,45,45,45,45,9,9,9,9,9,9,9,9,9,9,9,9,9,9,9,9,9,9,9,9,9,9,9,9,9,9,9,9,64,65,9,9,9,9,9,9,9,9,9,9,9,9,9,9,9,9,9,9,9,9,9,9,9,9,9,58,58,9,9,9,9,9,9,9,9,9,9,9,9,9,9,9,9,9,9,9,9,9,9,9,9,9,9,9,43,40,38,37,45,45,45,45,45,45,45,9,9,9,9,9,9,9,9,9,9,9,9,9,45
45,9,9,9,9,9,9,9,9,9,9,9,9,9,9,9,9,9,9,9,9,58,9,58,9,58,9,58,9,9,9,58,9,9,9,9,9,9,9,9,9,9,9,9,9,9,9,9,9,9,9,9,9,9,45,45,9,9,9,9,9,9,9,9,9,9,9,9,9,9,9,9,9,9,9,9,9,9,9,9,9,9,9,9,9,9,9,9,9,9,9,9,9,9,9,9,9,9,9,9,9,9,64,65,9,9,9,9,36,37,9,9,9,9,9,9,9,9,9,9,9,45,45,9,9,9,9,9,9,9,9,9,9,9,58,58,58,9,9,9,9,9,9,9,9,9,9,9,9,9,9,9,9,9,9,9,9,9,45,45,45,45,45,45,45,45,45,45,45,45,45,45,45,45,45,9,9,9,9,9,9,9,9,9,9,9,9,9,45
45,9,9,9,9,9,9,9,9,9,9,9,9,9,9,9,9,9,9,58,9,58,9,58,9,58,9,58,9,9,9,58,9,58,9,9,9,9,9,9,9,9,9,9,9,9,9,9,9,9,9,9,9,9,45,45,9,9,9,9,9,9,9,9,9,9,9,9,9,9,9,9,9,9,9,9,9,9,9,9,9,9,9,9,9,9,9,9,9,9,9,9,9,9,9,9,9,9,9,9,9,9,36,37,9,9,9,9,36,37,9,9,9,9,64,65,9,9,9,9,9,45,45,9,9,9,9,9,9,9,9,9,9,58,58,58,58,9,9,9,9,9,9,9,9,9,9,9,9,9,9,9,9,9,9,9,9,9,45,45,45,45,45,45,45,45,45,45,45,45,45,45,45,45,45,9,9,9,9,9,9,9,9,9,9,9,9,9,45
45,9,9,9,9,9,9,9,9,9,50,9,9,9,9,50,9,58,9,58,9,58,9,58,9,58,9,58,9,9,9,58,9,58,9,9,50,9,9,9,9,9,9,9,9,9,9,9,50,9,9,9,9,9,9,9,9,9,9,9,9,9,9,9,9,9,9,9,9,9,9,9,9,9,9,9,9,9,9,9,9,9,9,9,9,9,9,9,9,9,9,9,9,50,9,9,9,9,9,9,9,9,36,37,9,9,9,9,36,37,9,9,9,9,36,37,9,9,9,9,9,45,45,9,9,9,9,9,9,9,50,9,58,58,58,58,58,9,9,9,9,9,9,9,9,9,9,9,9,9,9,9,9,9,9,9,9,9,45,45,45,45,45,45,45,45,45,45,45,45,45,45,45,45,45,9,9,9,9,9,9,9,9,9,9,9,9,9,45
44,44,44,44,44,44,44,44,44,44,44,44,44,44,44,44,44,44,44,44,44,44,44,44,44,44,44,44,44,44,44,44,44,44,44,44,44,44,44,44,44,44,44,44,44,44,44,44,44,44,44,44,44,44,44,44,44,44,44,44,44,44,44,44,44,44,44,44,44,44,44,44,44,44,44,44,44,44,44,44,9,9,44,44,44,44,44,44,44,44,44,44,44,44,44,44,44,44,44,44,44,44,44,44,44,44,44,44,44,44,44,44,44,44,44,44,44,44,44,9,9,44,44,9,9,44,44,44,44,44,44,44,44,44,44,44,44,9,9,9,9,9,9,9,44,44,44,44,44,44,44,44,9,9,9,9,9,9,44,44,44,44,44,44,44,44,44,44,44,44,44,44,44,44,44,44,44,44,44,44,44,44,44,44,44,44,44,44,44
44,44,44,44,44,44,44,44,44,44,44,44,44,44,44,44,44,44,44,44,44,44,44,44,44,44,44,44,44,44,44,44,44,44,44,44,44,44,44,44,44,44,44,44,44,44,44,44,44,44,44,44,44,44,44,44,44,44,44,44,44,44,44,44,44,44,44,44,44,44,44,44,44,44,44,44,44,44,44,44,9,9,44,44,44,44,44,44,44,44,44,44,44,44,44,44,44,44,44,44,44,44,44,44,44,44,44,44,44,44,44,44,44,44,44,44,44,44,44,9,9,44,44,9,9,44,44,44,44,44,44,44,44,44,44,44,44,9,9,9,9,9,9,9,44,44,44,44,44,44,44,44,9,9,9,9,9,9,44,44,44,44,44,44,44,44,44,44,44,44,44,44,44,44,44,44,44,44,44,44,44,44,44,44,44,44,44,44,44
